17 5 17 5
E E
w w w w w w w w w w w w w w w w w w w w w w w w w w w w w w w w
w r g g g w g w g g g g g w g g g g g g g g g w g g g g w g 0 w
w g g g g w g w g g g g g w g w y 1 w w g g g w g g g g w g g w
w g g g g g g g g g w w w w g w w w w w g g g w g g g g w g g w
w g g g g w g w g g g w o w g w g g g w g g g w g g g g w g g w
w w g w w w g w g g g g g w g g g g g w g g g w g g g g g g g w
w g g g g g g w g g g w g w g w g g g w g g g g g g g g w g g w
w w w w w w w w w w w w w w w w w w w w w g w w w w g w w w w w
w g g g g g g g g g g w g g g w g g g g g g g w g g g w g g g w
w g g g g w g g g g g g g g g w g 2 g g g g g g g g g g g g g w
w g g g g w g g g g g w g g g g g g g g g g g w g g g w g g g w
w g 3 g g w g g g g g w g g g w g g g g g g g w g g g w g g g w
w g w w w w w w w w w w g w w w w w w w w w w w w w w w w w g w
w w w g g w g g g g w g g g g g w g g g g g g w g g g g g g g w
w g g g g w g g g g w g g g g g g g g g g g g w g g g g g g g w
w g g g g g g g g g w g g g g g w g g g g g g w w w g w w w g w
w g 4 g g w w g w w w g g g g g w w w w g g g g g w g w g g g w
w g g g g w g g g g w g g g g g g g g w 8 g g g g w g w g g g w
w w w g w w g g g g w g w w w w w g w w w w g w w w g w g g g w
w g g g g w g g g g w g g g g w g g g w g g g g g w g w w g w w
w g g g g w w w g w w g g g g w g g g w g g g g g g g w g g g w
w g g g g g g g g g w g w w w w g g g w g g g g g w g w g g g w
w g g g g w g g g g w g g g g w g g g w g w g w w w p w g g g w
w w g w w w g w w w w g g g 9 w g g g w g w g w w w w w g w w w
w g g g g w g g g g w g w w w w w w g w g w g g g g w g g g g w
w g g w w w g g g g w g g g g g g w g g g w g g g g w g g g g w
w g g g 5 w g w w w w w w w w w g w g g g w g w w w w 7 w g g w
w g g w w w g g g g w g g g g w g w g g g w g g g g w g w g g w
w g g g g w g g g g w g g g g w g g g g g w g g g g g g g g g w
w g g w w w g g g g w g 6 g g w g w w g w w g g g g w g g g g w
w g g g b w g g g g w g g g g g g w g g g g g g g g w g g g g w
w w w w w w w w w w w w w w w w w w w w w w w w w w w w w w w w